0000000000000000
0000000000000000
0000000000000000
0000000000000000
                
               2
               1
0000000000000001
0000000000000001
1000000000000001
1111111111111111
1111111111111111