1000000000000000
1000000000000000
1000000000000000
1000000000000000
1              2
1              1
1              1
1000000100000001
1000000100000001
1L00000100000001
1111111111111111
1111111111111111