0000000000000000
1000000000000000
1000000000000000
1000000000000000
1               
1              0
1               
1000000000000002
1000000000000001
10000000000000L1
1111111111111111
1111111111111111